34,32;
2c,2c,2c,2a,2a,2a,2a,2a,2a,2a,2a,2a,2a,2a,2a,2a,2a,2a,2a,2a,2a,2a,2a,2a,2a,2a,2a,2a,2a,2a,2a,2a
2c,2c,2c,2a,2a,2a,2a,2a,2a,2a,2a,2a,2a,2a,2a,2a,2a,2a,2a,2a,2a,2a,2a,2a,2a,2a,2a,2a,2a,2a,2a,2a
2a,2a,2a,2a,2a,2a,2a,2a,2a,2a,2a,2a,2a,2a,2a,2a,2a,2a,2a,2a,2a,2a,2a,2a,2a,2a,2a,2a,2a,2a,2a,2a
2a,2a,2a,2a,2a,2a,2a,2a,2a,2a,2a,2a,2a,2a,2a,2a,2a,2a,2a,2a,2a,2a,2a,2a,2a,2a,2a,2a,2a,2a,2a,2a
2a,2a,2a,2a,2a,2a,2a,2a,2a,2a,2a,2a,2a,2a,2a,2a,2a,2a,2a,2a,2a,2a,2a,2a,2a,2a,2a,2a,2a,2a,2a,2a
2a,2a,2a,2a,2a,2a,2a,2a,2a,2a,2a,2a,2a,2a,2a,2a,2a,2a,2a,2a,2a,2a,2a,2a,2a,2a,2a,2a,2a,2a,2a,2a
2a,2a,2a,2a,2a,2a,2a,2a,2a,2a,2a,2a,2a,2a,2a,2a,2a,2a,2a,2a,2a,2a,2a,2a,2a,2a,2a,2a,2a,2a,2a,2a
2a,2a,2a,2a,2a,2a,2a,2a,2a,2a,2a,2a,2a,2a,2a,2a,2a,2a,2a,2a,2a,2a,2a,2a,2a,2a,2a,2a,2a,2a,2a,2a
2a,2a,2a,2a,2a,2a,2a,2a,2a,2a,2a,2a,2a,2a,2a,2a,2a,2a,2a,2a,2a,2a,2a,2a,2a,2a,2a,2a,2a,2a,2a,2a
2a,2a,2a,2a,2a,2a,2a,2a,2a,2a,2a,2a,2a,2a,2a,2a,2a,2a,2a,2a,2a,2a,2a,2a,2a,2a,2a,2a,2a,2a,2a,2a
2a,2a,2a,2a,2a,2a,2a,2a,2a,2a,2a,2a,2a,2a,2a,2a,2a,2a,2a,2a,2a,2a,2a,2a,2a,2a,2a,2a,2a,2a,2a,2a
2a,2a,2a,2a,2a,2a,2a,2a,2a,2a,2a,2a,2a,2a,2a,2a,2a,2a,2a,2a,2a,2a,2a,2a,2a,2a,2a,2a,2a,2a,2a,2a
2a,2a,2a,2a,2a,2a,2a,2a,2a,2a,2a,2a,2a,2a,2a,2a,2a,2a,2a,2a,2a,2a,2a,2a,2a,2a,2a,2a,2a,2a,2a,2a
2a,2a,2a,2a,2a,2a,2a,2a,2a,2a,2a,2a,2a,2a,2a,2a,2a,2a,2a,2a,2a,2a,2a,2a,2a,2a,2a,2a,2a,2a,2a,2a
2a,2a,2a,2a,2a,2a,2a,2a,2a,2a,2a,2a,2a,1b,1b,1b,2a,2a,2a,2a,2a,2a,2a,2a,2a,2a,2a,2a,2a,2a,2a,2a
2a,2a,2a,2a,2a,2a,2a,2a,2a,2a,2a,2a,2a,1b,1b,1b,2a,2a,2a,2a,2a,2a,2a,2a,2a,2a,2a,2a,2a,2a,2a,2a
2a,2a,2a,2a,2a,2a,2a,2a,2a,2a,2a,2a,2a,1b,1b,1b,2a,2a,2a,2a,2a,2a,2a,2a,2a,2a,2a,2a,2a,2a,2a,2a
2a,2a,2a,2a,2a,2a,2a,2a,2a,2a,2a,2a,2a,2a,2a,2a,2a,2a,2a,2a,2a,2a,2a,2a,2a,2a,2a,2a,2a,2a,2a,2a
2a,2a,2a,2a,2a,2a,2a,2a,2a,2a,2a,2a,2a,2a,2a,2a,2a,2a,2a,2a,2a,2a,2a,2a,2a,2a,2a,2a,2a,2a,2a,2a
2a,2a,2a,2a,2a,2a,2a,2a,2a,2a,2a,2a,2a,2a,2a,2a,2a,2a,2a,2a,2a,2a,2a,2a,2a,2a,2a,2a,2a,2a,2a,2a
2a,2a,2a,2a,2a,2a,2a,2a,2a,2a,2a,2a,2a,2a,2a,2a,2a,2a,2a,2a,2a,2a,2a,2a,2a,2a,2a,2a,2a,2a,2a,2a
2a,2a,2a,2a,2a,2a,2a,2a,2a,2a,2a,2a,2a,2a,2a,2a,2a,2a,2a,2a,2a,2a,2a,2a,2a,2a,2a,2a,2a,2a,2a,2a
2a,2a,2a,2a,2a,2a,2a,2a,2a,2a,2a,2a,2a,2a,2a,2a,2a,2a,2a,2a,2a,2a,2a,2a,2a,2a,2a,2a,2a,2a,2a,2a
2a,2a,2a,2a,2a,2a,2a,2a,2a,2a,2a,2a,2a,2a,2a,2a,2a,2a,2a,2a,2a,2a,2a,2a,2a,2a,2a,2a,2a,2a,2a,2a
2a,2a,2a,2a,2a,2a,2a,2a,2a,2a,2a,2a,2a,2a,2a,2a,2a,2a,2a,2a,2a,2a,2a,2a,2a,2a,2a,2a,2a,2a,2a,2a
2a,2a,2a,2a,2a,2a,2a,2a,2a,2a,2a,2a,2a,2a,2a,2a,2a,2a,2a,2a,2a,2a,2a,2a,2a,2a,2a,2a,2a,2a,2a,2a
2a,2a,2a,2a,2a,2a,2a,2a,2a,2a,2a,2a,2a,2a,2a,2a,2a,2a,2a,2a,2a,2a,2a,2a,2a,2a,2a,2a,2a,2a,2a,2a
2a,2a,2a,2a,2a,2a,2a,2a,2a,2a,2a,2a,2a,2a,2a,2a,2a,2a,2a,2a,2a,2a,2a,2a,2a,2a,2a,2a,2a,2a,2a,2a
2a,2a,2a,2a,2a,2a,2a,2a,2a,2a,2a,2a,2a,2a,2a,2a,2a,2a,2a,2a,2a,2a,2a,2a,2a,2a,2a,2a,2a,2a,2a,2a
2a,2a,2a,2a,2a,2a,2a,2a,2a,2a,2a,2a,2a,2a,2a,2a,2a,2a,2a,2a,2a,2a,2a,2a,2a,2a,2a,2a,2a,2a,2a,2a
2a,2a,2a,2a,2a,2a,2a,2a,2a,2a,2a,2a,2a,2a,2a,2a,2a,2a,2a,2a,2a,2a,2a,2a,2a,2a,2a,2a,2a,2a,2a,2a
2a,2a,2a,2a,2a,2a,2a,2a,2a,2a,2a,2a,2a,1b,1b,1b,2a,2a,2a,2a,2a,2a,2a,2a,2a,2a,2a,2a,2a,2a,2a,2a
2a,2a,2a,2a,2a,2a,2a,2a,2a,2a,2a,2a,2a,1b,1b,1b,2a,2a,2a,2a,2a,2a,2a,2a,2a,2a,2a,2a,2a,2a,2a,2a
2a,2a,2a,2a,2a,2a,2a,2a,2a,2a,2a,2a,2a,1b,1b,1b,2a,2a,2a,2a,2a,2a,2a,2a,2a,2a,2a,2a,2a,2a,2a,2a