38,40;
1a,1a,1a,1a,1a,1a,1a,1a,1a,1a,1a,1a,1a,1a,1a,1a,1a,1a,1a,1a,1a,1a,1a,1a,1a,1a,1a,1a,1a,1a,1a,1a,1a,1a,1a,1a,1a,1a,1a,1a
2a,2a,2a,2a,2a,2a,2a,2a,2a,2a,2a,2a,2a,2a,2a,2a,2a,2a,2a,2a,2a,2a,2a,2a,2a,2a,2a,2a,2a,2a,2a,2a,2a,2a,2a,2a,2a,2a,2a,2a
2a,2a,2a,2a,2a,2a,2a,2a,2a,2a,2a,2a,2a,2a,2a,2a,2a,2a,2a,2a,2a,2a,2a,2a,2a,2a,2a,2a,2a,2a,2a,2a,2a,2a,2a,2a,2a,2a,2a,2a
2a,2a,2a,2a,2a,2a,2a,2a,2a,2a,2a,2a,2a,2a,2a,2a,2a,2a,2a,2a,2a,2a,2a,2a,2a,2a,2a,2a,2a,2a,2a,2a,2a,2a,2a,2a,2a,2a,1a,2a
2a,2a,2a,2a,2a,2a,2a,2a,2a,2a,2a,2a,2a,2a,2a,2a,2a,2a,2a,2a,2a,2a,2a,2a,2a,2a,2a,2a,2a,2a,2a,2a,2a,2a,2a,2a,2a,2a,1a,2a
2a,2a,2a,2a,2a,2a,2a,2a,2a,2a,2a,2a,2a,2a,2a,2a,2a,2a,2a,2a,2a,2a,2a,2a,2a,2a,2a,2a,2a,2a,2a,2a,2a,2a,2a,2a,2a,2a,1a,2a
2a,2a,2a,2a,2a,2a,2a,2a,2a,2a,2a,2a,2a,2a,2a,2a,2a,2a,2a,2a,2a,2a,2a,2a,2a,2a,2a,2a,2a,2a,2a,2a,2a,2a,2a,2a,2a,2a,1a,2a
2a,2a,2a,2a,2a,2a,2a,2a,2a,2a,2a,2a,2a,2a,2a,2a,2a,2a,2a,2a,2a,2a,2a,2a,2a,2a,2a,2a,2a,2a,2a,2a,2a,2a,2a,2a,2a,2a,1a,2a
2a,2a,2a,2a,2a,2a,2a,2a,2a,2a,2a,2a,2a,2a,2a,2a,2a,2a,2a,2a,2a,2a,2a,2a,2a,2a,2a,2a,2a,2a,2a,2a,2a,2a,2a,2a,2a,2a,1a,2a
2a,2a,2a,2a,2a,2a,2a,2a,2a,2a,2a,2a,2a,2a,2a,2a,2a,2a,2a,2a,2a,2a,2a,2a,2a,2a,2a,2a,2a,2a,2a,2a,2a,2a,2a,2a,2a,2a,1a,2a
2a,2a,2a,2a,2a,2a,2a,2a,2a,2a,2a,2a,2a,2a,2a,2a,2a,2a,2a,2a,2a,2a,2a,2a,2a,2a,2a,2a,2a,2a,2a,2a,2a,2a,2a,2a,2a,2a,1a,2a
2a,2a,2a,2a,2a,2a,2a,2a,2a,2a,2a,2a,2a,2a,2a,2a,2a,2a,2a,2a,2a,2a,2a,2a,2a,2a,2a,2a,2a,2a,2a,2a,2a,2a,2a,2a,2a,2a,1a,2a
2a,2a,2a,2a,2a,2a,2a,2a,2a,2a,2a,2a,2a,2a,2a,2a,2a,2a,2a,2a,2a,2a,2a,2a,2a,2a,2a,2a,2a,2a,2a,2a,2a,2a,2a,2a,2a,2a,2a,2a
2a,2a,2a,2a,2a,2a,2a,2a,2a,2a,2a,2a,2a,2a,2a,2a,2a,2a,2a,2a,2a,2a,2a,2a,2a,2a,2a,2a,2a,2a,2a,2a,2a,2a,2a,2a,2a,2a,2a,2a
2a,2a,2a,2a,2a,2a,2a,2a,2a,2a,2a,2a,2a,2a,2a,2a,2a,2a,2a,2a,2a,2a,2a,2a,2a,2a,2a,2a,2a,2a,2a,2a,2a,2a,2a,2a,2a,2a,2a,2a
2a,2a,2a,2a,2a,2a,2a,2a,2a,2a,2a,2a,2a,2a,2a,2a,2a,2a,2a,2a,2a,2a,2a,2a,2a,2a,2a,2a,2a,2a,2a,2a,2a,2a,2a,2a,2a,2a,2a,2a
2a,2a,2a,2a,2a,2a,2a,2a,2a,2a,2a,2a,2a,2a,2a,2a,2a,2a,2a,2a,2a,2a,2a,2a,2a,2a,2a,2a,2a,2a,2a,2a,2a,2a,2a,2a,2a,2a,2a,2a
2a,2a,2a,2a,2a,2a,2a,2a,2a,2a,2a,2a,2a,2a,2a,2a,2a,2a,2a,2a,2a,2a,2a,2a,2a,2a,2a,2a,2a,2a,2a,2a,2a,2a,2a,2a,2a,2a,2a,2a
2a,2a,2a,2a,2a,2a,2a,2a,2a,2a,2a,2a,2a,2a,2a,2a,2a,2a,2a,2a,2a,2a,2a,2a,2a,2a,2a,2a,2a,2a,2a,2a,2a,2a,2a,2a,2a,2a,2a,2a
2a,2a,2a,2a,2a,2a,2a,2a,2a,2a,2a,2a,2a,2a,2a,2a,2a,2a,2a,2a,2a,2a,2a,2a,2a,2a,2a,2a,2a,2a,2a,2a,2a,2a,2a,2a,2a,2a,2a,2a
2a,2a,2a,2a,2a,2a,2a,2a,2a,2a,2a,2a,2a,2a,2a,2a,2a,2a,2a,2a,2a,2a,2a,2a,2a,2a,2a,2a,2a,2a,2a,2a,2a,2a,2a,2a,2a,2a,2a,2a
2a,2a,2a,2a,2a,2a,2a,2a,2a,2a,2a,2a,2a,2a,2a,2a,2a,2a,2a,2a,2a,2a,2a,2a,2a,2a,2a,2a,2a,2a,2a,2a,2a,2a,2a,2a,2a,2a,2a,2a
2a,2a,2a,2a,2a,2a,2a,2a,2a,2a,2a,2a,2a,2a,2a,2a,2a,2a,2a,2a,2a,2a,1a,1a,1a,1a,1a,2a,2a,2a,2a,2a,2a,2a,2a,2a,2a,2a,2a,2a
2a,2a,2a,2a,2a,2a,2a,2a,2a,2a,2a,2a,2a,2a,2a,2a,2a,2a,2a,2a,2a,2a,1a,1a,1a,1a,1a,2a,2a,2a,2a,2a,2a,2a,2a,2a,2a,2a,2a,2a
2a,2a,2a,2a,2a,2a,2a,2a,2a,2a,2a,2a,2a,2a,2a,2a,2a,2a,2a,2a,2a,2a,1a,1a,1a,1a,1a,2a,2a,2a,2a,2a,2a,2a,2a,2a,2a,2a,2a,2a
2a,2a,2a,2a,2a,2a,2a,2a,2a,2a,2a,2a,2a,2a,2a,2a,2a,2a,2a,2a,2a,2a,2a,2a,2a,2a,2a,2a,2a,2a,2a,2a,2a,2a,2a,2a,2a,2a,2a,2a
2a,2a,2a,2a,2a,2a,2a,2a,2a,2a,2a,2a,2a,2a,2a,2a,2a,2a,2a,2a,2a,2a,2a,2a,2a,2a,2a,2a,2a,2a,2a,2a,2a,2a,2a,2a,2a,2a,2a,2a
2a,2a,2a,2a,2a,2a,2a,2a,2a,2a,2a,2a,2a,2a,2a,2a,2a,2a,2a,2a,2a,2a,2a,2a,2a,2a,2a,2a,2a,2a,2a,2a,2a,2a,2a,2a,2a,2a,2a,2a
2a,2a,2a,2a,2a,2a,2a,2a,2a,2a,2a,2a,2a,2a,2a,2a,2a,2a,2a,2a,2a,2a,2a,2a,2a,2a,2a,2a,2a,2a,2a,2a,2a,2a,2a,2a,2a,2a,2a,2a
2a,2a,2a,2a,2a,2a,2a,2a,2a,2a,2a,2a,2a,2a,2a,2a,2a,2a,2a,2a,2a,2a,2a,2a,2a,2a,2a,2a,2a,2a,2a,2a,2a,2a,2a,2a,2a,2a,2a,2a
2a,2a,2a,2a,2a,2a,2a,2a,2a,2a,2a,2a,2a,2a,2a,2a,2a,2a,2a,2a,2a,2a,2a,2a,2a,2a,2a,2a,2a,2a,2a,2a,2a,2a,2a,2a,2a,2a,2a,2a
2a,2a,2a,2a,2a,2a,2a,2a,2a,2a,2a,2a,2a,2a,2a,2a,2a,2a,2a,2a,2a,2a,2a,2a,2a,2a,2a,2a,2a,2a,2a,2a,2a,2a,2a,2a,2a,2a,2a,2a
2a,2a,2a,2a,2a,2a,2a,2a,2a,2a,2a,2a,2a,2a,2a,2a,2a,2a,2a,2a,2a,2a,2a,2a,2a,2a,2a,2a,2a,2a,2a,2a,2a,2a,2a,2a,2a,2a,2a,2a
2a,2a,2a,2a,2a,2a,2a,2a,2a,2a,2a,2a,2a,2a,2a,2a,2a,1a,1a,1a,2a,2a,2a,2a,2a,2a,2a,2a,2a,2a,2a,2a,2a,2a,2a,2a,2a,2a,2a,2a
2a,2a,2a,2a,2a,2a,2a,2a,2a,2a,2a,2a,2a,2a,2a,2a,2a,1a,1a,1a,2a,2a,2a,2a,2a,2a,2a,2a,2a,2a,2a,2a,2a,2a,2a,2a,2a,2a,2a,2a
2a,2a,2a,2a,2a,2a,2a,2a,2a,2a,2a,2a,2a,2a,2a,2a,2a,1a,1a,1a,2a,2a,2a,2a,2a,2a,2a,2a,2a,2a,2a,2a,2a,2a,2a,2a,2a,2a,2a,2a
2a,2a,2a,2a,2a,2a,2a,2a,2a,2a,2a,2a,2a,2a,2a,2a,2a,1a,1a,1a,2a,2a,2a,2a,2a,2a,2a,2a,2a,2a,2a,2a,2a,2a,2a,2a,2a,2a,2a,2a
2a,2a,2a,2a,2a,2a,2a,2a,2a,2a,2a,1a,1a,1a,1a,1a,1a,1a,1a,1a,2a,2a,2a,2a,2a,2a,2a,2a,2a,2a,2a,2a,2a,2a,2a,2a,2a,2a,2a,2a