34,32;
0a,2a,2a,2a,2a,2a,2a,2a,2a,2a,2a,2a,2a,2a,2a,2a,2a,2a,2a,2a,2a,2a,2a,2a,2a,2a,2a,2a,2a,2a,2a,2a
0a,2a,2a,2a,2a,2a,2a,2a,2a,2a,2a,2a,2a,2a,2a,2a,2a,2a,2a,2a,2a,2a,2a,2a,2a,2a,2a,2a,2a,2a,2a,2a
2a,2a,2a,2a,2a,2a,2a,2a,2a,2a,2a,2a,2a,2a,2a,2a,2a,2a,2a,2a,2a,2a,2a,2a,2a,2a,2a,2a,2a,2a,2a,2a
2a,2a,2a,2a,2a,2a,2a,2a,2a,2a,2a,2a,2a,2a,2a,2a,2a,2a,2a,2a,2a,2a,2a,2a,2a,2a,2a,2a,2a,2a,2a,2a
2a,2a,2a,2a,2a,2a,2a,2a,2a,2a,2a,2a,2a,2a,2a,2a,2a,2a,2a,2a,2a,2a,2a,2a,2a,2a,2a,2a,2a,2a,2a,2a
2a,2a,2a,2a,2a,2a,2a,2a,2a,2a,5a,4a,3a,2a,2a,2a,2a,2a,2a,2a,2a,2a,2a,2a,2a,2a,2a,2a,2a,2a,2a,2a
2a,2a,2a,2a,2a,2a,2a,2a,2a,2a,4a,4a,4a,2a,2a,2a,2a,2a,2a,2a,2a,2a,2a,2a,2a,2a,2a,2a,2a,2a,2a,2a
2a,2a,2a,2a,2a,2a,2a,2a,2a,2a,4a,4a,4a,2a,2a,2a,2a,2a,2a,2a,2a,2a,2a,2a,2a,2a,2a,2a,2a,2a,2a,2a
2a,2a,2a,2a,2a,2a,2a,2a,2a,2a,4a,4a,4a,2a,2a,2a,2a,2a,2a,2a,2a,2a,2c,2c,2a,2a,2a,2a,2a,2a,2a,2a
2a,2a,2a,2a,2a,2a,2a,2a,2a,2a,6a,4a,7a,2a,2a,2a,2a,2a,2a,2a,2a,2a,2c,2c,2a,2a,2a,2a,2a,2a,2a,2a
2a,2a,2a,2a,2a,2a,2a,2a,2a,2a,2a,2a,2a,2a,2a,2a,2a,2a,2a,2a,2a,2a,2c,2c,2a,2a,2a,2a,2a,2a,2a,2a
2a,2a,2a,2a,2a,2a,2a,2a,2a,2a,2a,2a,2a,2a,2a,2a,2a,2a,2a,2a,2a,2a,2a,2a,2a,2a,2a,2a,2a,2a,2a,2a
2a,2a,2a,2a,2a,2a,2a,2a,2a,2a,2a,2a,2a,2a,2a,2a,2a,2a,2a,2a,2a,2a,2a,2a,2a,2a,2a,2a,2a,2a,2a,2a
2a,2a,2a,2a,2a,2a,2a,2a,2a,2a,2a,2a,2a,2a,2a,2a,2a,2a,2a,2a,2a,2a,2a,2a,2a,2a,2a,2a,2a,2a,2a,2a
2a,2a,2a,2a,2a,2a,2a,2a,2a,2a,2a,2a,2a,1b,1b,1b,2a,2a,2a,2a,2a,2a,2a,2a,2a,2a,2a,2a,2a,2a,2a,2a
2a,2a,2a,2a,2a,2a,2a,2a,2a,2a,2a,2a,2a,1b,1b,1b,2a,2a,2a,2a,2a,2a,2a,2a,2a,2a,2a,2a,2a,2a,2a,2a
2a,2a,2a,2a,2a,2a,2a,2a,2a,2a,2a,2a,2a,1b,1b,1b,2a,2a,2a,2a,2a,2a,2a,2a,2a,2a,2a,2a,2a,2a,2a,2a
2a,2a,2a,2a,2a,2a,2a,2a,2a,2a,2a,2a,2a,2a,2a,2a,2a,2a,2a,2a,2a,2a,2a,2a,2a,2a,2a,2a,2a,2a,2a,2a
2a,2a,2a,2a,2a,2a,2a,2a,2a,2a,2a,2a,2a,2a,2a,2a,2a,2a,2a,2a,2a,2a,2a,2a,2a,2a,2a,2a,2a,2a,2a,2a
2a,2a,2a,2a,2a,2a,2a,2a,2a,2a,2a,2a,2a,2a,2a,2a,2a,2a,2a,2a,2a,2a,2a,2a,2a,2a,2a,2a,2a,2a,2a,2a
2a,2a,2a,2a,2a,2a,2a,2a,2a,2a,2a,2a,2a,2a,2a,2a,2a,2a,2a,2a,2a,2a,2a,2a,2a,2a,2a,2a,2a,2a,2a,2a
2a,2a,2a,2a,2a,2a,2a,2a,2a,2a,2a,2a,2a,2a,2a,2a,2a,2a,2a,2a,2a,2a,2a,2a,2a,2a,2a,2a,2a,2a,2a,2a
2a,2a,2a,2a,2a,2a,2a,2a,2a,2a,2a,2a,2a,2a,2a,2a,2a,2a,2a,2a,2a,2a,2a,2a,2a,2a,2a,2a,2a,2a,2a,2a
2a,2a,2a,2a,2a,2a,2a,2a,2a,2a,2a,2a,2a,2a,2a,2a,2a,2a,2a,2a,2a,2a,2a,2a,2a,2a,2a,2a,2a,2a,2a,2a
2a,2a,2a,2a,2a,2a,2a,2a,2a,2a,2a,2a,2a,2a,2a,2a,2a,2a,2a,2a,2a,2a,2a,2a,2a,2a,2a,2a,2a,2a,2a,2a
2a,2a,2a,2a,2a,2a,2a,2a,2a,2a,2a,2a,2a,2a,2a,2a,2a,2a,2a,2a,2a,2a,2a,2a,2a,2a,2a,2a,2a,2a,2a,2a
2a,2a,2a,2a,2a,2a,2a,2a,2a,2a,2a,2a,2a,2a,2a,2a,2a,2a,2a,2a,2a,2a,2a,2a,2a,2a,2a,2a,2a,2a,2a,2a
2a,2a,2a,2a,2a,2a,2a,2a,2a,2a,2a,2a,2a,2a,2a,2a,2a,2a,2a,2a,2a,2a,2a,2a,2a,2a,2a,2a,2a,2a,2a,2a
2a,2a,2a,2a,2a,2a,2a,2a,2a,2a,2a,2a,2a,2a,2a,2a,2a,2a,2a,2a,2a,2a,2a,2a,2a,2a,2a,2a,2a,2a,2a,2a
2a,2a,2a,2a,2a,2a,2a,2a,2a,2a,2a,2a,2a,2a,2a,2a,2a,2a,2a,2a,2a,2a,2a,2a,2a,2a,2a,2a,2a,2a,2a,2a
2a,2a,2a,2a,2a,2a,2a,2a,2a,2a,2a,2a,2a,2a,2a,2a,2a,2a,2a,2a,2a,2a,2a,2a,2a,2a,2a,2a,2a,2a,2a,2a
2a,2a,2a,2a,2a,2a,2a,2a,2a,2a,2a,2a,2a,1b,1b,1b,2a,2a,2a,2a,2a,2a,2a,2a,2a,2a,2a,2a,2a,2a,2a,2a
2a,2a,2a,2a,2a,2a,2a,2a,2a,2a,2a,2a,2a,1b,1b,1b,2a,2a,2a,2a,2a,2a,2a,2a,2a,2a,2a,2a,2a,2a,2a,2a
2a,2a,2a,2a,2a,2a,2a,2a,2a,2a,2a,2a,2a,1b,1b,1b,2a,2a,2a,2a,2a,2a,2a,2a,2a,2a,2a,2a,2a,2a,2a,2a
